1111111111111111111111111
1000000010000000100000001
1000100000001000000000001
1011100010000000100000001
1000000010001000100000001
1000000100001000010000001
1111000100000000010001111
1000001000000000001000001
1000010000001000000100001
1000001000000000001000001
1111000100000000010001111
1000000100001000010000001
1000000010001000100000001
1011100010000000100011101
1000100000001000000010001
1000000010000000100000001
1111111111111111111111111
