1111111111111111111111111
1000000111100011110000001
1010000010001000100000101
1010101010101010101010101
1000000000000000000000001
1001101100000000011011001
1001010010001000100101001
1000000000000000000000001
1111011101110111011101111 
1000000000000000000000001
1001010010001000100101001
1001101100000000011011001
1000000000000000000000001
1010101010101010101010101
1010000010001000100000101
1000000111100011110000001
1111111111111111111111111